1 7 753 770 771 761 719 725 708 
1 2 761 766 
1 9 771 798 837 856 880 889 919 939 965 
1 15 965 1027 966 985 1009 1021 1038 1049 1063 1064 1075 1103 1107 1125 1117 
1 10 1103 1122 1152 1155 1158 1170 1178 1200 1177 1194 
1 4 1117 1132 1156 1166 
1 5 1166 1190 1215 1206 1238 
1 3 889 901 908 
1 7 965 982 980 968 962 938 908 
1 4 889 893 842 835 
1 5 770 811 830 850 895 
1 5 850 822 861 810 797 
1 14 753 729 697 658 648 669 647 631 634 630 587 550 525 526 
1 4 525 512 492 453 
1 3 630 659 655 
1 5 697 685 717 748 797 
1 2 685 648 
1 3 811 826 837 
1 2 798 826 
1 3 908 886 856 
1 2 893 919 
1 3 1027 993 1021 
1 2 1063 1075 
1 2 492 489 
1 8 4251 4288 4323 4339 4378 4393 4430 4465 
1 6 4251 4244 4278 4294 4247 4220 
1 6 4251 4203 4186 4153 4120 4068 
1 8 4251 4230 4205 4168 4127 4139 4130 4122 
1 4 4127 4108 4069 4046 
1 10 4127 4108 4075 4028 4003 3957 3924 3885 3855 3815 
1 10 4251 4271 4311 4347 4352 4408 4474 4482 4536 4576 
1 11 4408 4466 4526 4567 4625 4631 4583 4525 4481 4447 4407 
1 11 4251 4271 4254 4231 4255 4241 4221 4227 4215 4163 4132 
1 6 4215 4248 4279 4318 4330 4366 
1 6 4366 4419 4438 4475 4520 4585 
1 7 4366 4365 4369 4386 4374 4425 4462 
1 8 4366 4324 4281 4263 4264 4275 4265 4216 
1 5 4216 4219 4222 4213 4198 
1 4 4216 4149 4117 4116 
1 9 4216 4187 4141 4071 4007 3963 3908 3928 3872 
1 11 4216 4187 4141 4096 4059 4060 4061 4080 4053 4054 4005 
1 4 4005 4009 4004 3951 
1 12 4005 3958 3895 3862 3816 3761 3725 3722 3742 3688 3650 3594 
1 16 4005 3968 3906 3858 3801 3850 3866 3857 3794 3773 3716 3684 3646 3613 3575 3554 
1 16 3857 3824 3818 3778 3786 3739 3715 3680 3648 3634 3611 3599 3570 3572 3581 3582 
1 12 5034 4968 4960 4959 4914 4882 4816 4787 4753 4721 4650 4620 
1 8 5034 5097 5154 5224 5293 5392 5504 5570 
1 4 5034 5043 4984 5006 
1 3 5558 5605 5570 
1 8 5034 4972 4906 4852 4777 4738 4716 4656 
1 8 4620 4611 4601 4566 4582 4551 4562 4614 
1 3 4614 4673 4722 
1 4 4614 4674 4711 4788 
1 3 4716 4701 4661 
1 13 5034 5033 5083 5071 5054 5085 5070 5067 5061 5042 5041 5053 5040 
1 6 5034 5033 5083 5071 5054 5009 
1 5 5034 5033 5083 5071 5120 
1 5 5042 5108 5147 5207 5298 
1 2 5147 5234 
1 6 5147 5107 5041 4991 4942 4870 
1 7 4620 4671 4670 4724 4792 4758 4870 
1 6 4722 4787 4851 4948 4992 5009 
1 3 4788 4898 4968 
1 10 5298 5360 5366 5348 5292 5273 5206 5162 5091 5090 
