2 7 753 770 771 761 719 725 708 
1 2 761 766 
3 9 771 798 837 856 880 889 919 939 965 
2 13 965 1027 966 985 1009 1021 1038 1049 1063 1064 1075 1103 1107 
1 10 1103 1122 1152 1155 1158 1170 1178 1200 1177 1194 
2 5 1166 1190 1215 1206 1238 
3 3 889 901 908 
2 7 965 982 980 968 962 938 908 
3 4 889 893 842 835 
2 5 770 811 830 850 895 
2 5 850 822 861 810 797 
2 14 753 729 697 658 648 669 647 631 634 630 587 550 525 526 
1 4 525 512 492 453 
1 3 630 659 655 
1 5 697 685 717 748 797 
1 2 685 648 
3 3 811 826 837 
1 2 798 826 
1 3 908 886 856 
1 2 893 919 
1 3 1027 993 1021 
1 2 1063 1075 
4 8 4251 4288 4323 4339 4378 4393 4430 4465 
3 6 4251 4244 4278 4294 4247 4220 
4 6 4251 4203 4186 4153 4120 4068 
4 8 4251 4230 4205 4168 4127 4139 4130 4122 
2 4 4127 4108 4069 4046 
3 10 4127 4108 4075 4028 4003 3957 3924 3885 3855 3815 
3 10 4251 4271 4311 4347 4352 4408 4474 4482 4536 4576 
3 11 4408 4466 4526 4567 4625 4631 4583 4525 4481 4447 4407 
3 19 4251 4271 4254 4231 4255 4241 4221 4227 4215 4163 4132 4105 4106 4085 4078 4029 3992 3939 3872 
3 6 4215 4248 4279 4318 4330 4366 
2 9 4366 4419 4438 4475 4520 4585 4652 4695 4729 
3 7 4366 4365 4369 4386 4374 4425 4462 
3 8 4366 4324 4281 4263 4264 4275 4265 4216 
2 5 4216 4219 4222 4213 4198 
2 4 4216 4149 4117 4116 
3 9 4216 4187 4141 4071 4007 3963 3908 3928 3872 
3 11 4216 4187 4141 4096 4059 4060 4061 4080 4053 4054 4005 
2 4 4005 4009 4004 3951 
3 12 4005 3958 3895 3862 3816 3761 3725 3722 3742 3688 3650 3594 
4 16 4005 3968 3906 3858 3801 3850 3866 3857 3794 3773 3716 3684 3646 3613 3575 3554 
3 16 3857 3824 3818 3778 3786 3739 3715 3680 3648 3634 3611 3599 3570 3572 3581 3582 
3 12 5034 4968 4960 4959 4914 4882 4816 4787 4753 4721 4650 4620 
3 8 5034 5097 5154 5224 5293 5392 5504 5570 
2 4 5034 5043 4984 5006 
1 3 5558 5605 5570 
3 8 5034 4972 4906 4852 4777 4738 4716 4656 
1 8 4620 4611 4601 4566 4582 4551 4562 4614 
2 3 4614 4673 4722 
2 4 4614 4674 4711 4788 
1 3 4716 4701 4661 
3 13 5034 5033 5083 5071 5054 5085 5070 5067 5061 5042 5041 5053 5040 
1 6 5034 5033 5083 5071 5054 5009 
3 8 5034 5033 5083 5071 5120 5149 5172 5235 
2 5 5042 5108 5147 5207 5298 
1 2 5147 5234 
2 6 5147 5107 5041 4991 4942 4870 
1 7 4620 4671 4670 4724 4792 4758 4870 
2 6 4722 4787 4851 4948 4992 5009 
3 3 4788 4898 4968 
1 10 5298 5360 5366 5348 5292 5273 5206 5162 5091 5090 
2 4 4407 4396 4413 4408 
3 5 4525 4503 4460 4473 4465 
2 5 4374 4424 4461 4488 4536 
2 4 4462 4513 4530 4585 
2 4 4122 4115 4137 4132 
2 5 4068 4034 4042 4028 4003 
2 4 4068 4094 4136 4127 
2 5 3801 3799 3802 3812 3816 
2 6 3613 3629 3630 3620 3600 3594 
1 5 3857 3881 3935 3994 4007 
1 6 4080 4036 3977 3925 3866 3857 
2 5 3648 3644 3652 3684 3716 
1 4 3778 3793 3811 3872 
2 5 3688 3687 3702 3774 3801 
1 10 3949 3967 3972 3995 4023 4051 4083 4100 4126 4119 
2 10 3949 3967 3972 3946 3923 3896 3897 3898 3834 3810 
3 7 3949 3967 3972 3973 3961 3985 4002 
2 5 3949 3918 3863 3871 3837 
2 8 3949 3938 3914 3945 3933 3917 3922 3941 
1 2 3914 3956 
3 4 3764 3808 3846 3883 
1 4 3764 3808 3798 3848 
2 4 3764 3784 3836 3868 
1 3 3764 3745 3756 
2 4 3632 3639 3610 3617 
2 4 3617 3638 3663 3679 
2 6 3632 3664 3633 3590 3579 3553 
3 10 4632 4686 4739 4764 4857 4933 4994 5036 5086 5142 
2 4 4632 4676 4729 4746 
1 4 4764 4857 4933 4950 
3 8 5209 5208 5240 5173 5137 5109 5056 4995 
1 9 5209 5208 5240 5173 5137 5109 5044 5015 5045 
3 9 5209 5301 5361 5428 5507 5595 5674 5726 5774 
2 5 5595 5596 5608 5632 5617 
2 4 5473 5411 5325 5241 
1 3 5473 5411 5433 
1 3 5473 5609 5617 
3 2 5349 5235 
2 8 5349 5448 5460 5582 5665 5767 5817 5878 
2 6 6104 6011 5972 5923 5823 5822 
3 6 6104 6037 6012 5964 5889 5878 
1 6 6104 6144 6211 6275 6325 6419 
1 3 6104 6158 6236 
2 5 5889 5824 5766 5730 5695 
1 3 5822 5725 5664 
2 4 5889 5910 5924 5972 
1 4 4714 4740 4771 4803 
1 4 4803 4771 4730 4731 
3 14 6047 5983 5966 5911 5858 5768 5745 5668 5607 5534 5462 5409 5332 5283 
1 4 5409 5533 5606 5667 
1 4 6047 6014 5965 5969 
2 11 5911 5880 5825 5851 5836 5893 5958 6015 6006 6022 6051 
3 9 6047 6114 6115 6152 6153 6188 6140 6160 6165 
1 3 6160 6092 6069 
1 3 6160 6092 6006 
3 6 6160 6252 6303 6364 6432 6512 
3 4 6364 6398 6442 6502 
2 8 6502 6608 6700 6788 6840 6891 6973 7002 
1 7 5732 5793 5890 5925 5997 6099 6172 
1 3 5938 5857 5809 
1 4 5938 5879 5850 5865 
2 4 5938 5987 6045 6058 
2 4 5938 6013 6038 6163 
2 9 6669 6567 6544 6431 6373 6342 6315 6203 6139 
2 5 6669 6633 6698 6796 6857 
1 3 6857 6916 7020 
1 4 6857 6916 6839 6875 
1 3 7020 7029 6902 
1 3 6315 6264 6314 
2 8 7188 7140 7091 7028 6926 6874 6805 6679 
2 9 7188 7065 7018 6934 6825 6774 6593 6540 6460 
1 4 6460 6470 6397 6302 
1 5 6460 6470 6511 6606 6697 
2 9 7188 7212 7318 7304 7404 7475 7568 7643 7702 
2 6 7475 7441 7367 7277 7257 7174 
2 5 6453 6376 6288 6224 6183 
1 3 6183 6243 6305 
2 6 6453 6413 6345 6318 6266 6241 
1 3 6241 6174 6084 
2 8 6084 6116 6173 6280 6344 6343 6433 6503 
1 7 1515 1476 1503 1500 1518 1580 1638 
2 6 1500 1447 1416 1350 1307 1217 
1 4 1307 1371 1415 1476 
1 2 451 441 
1 10 911 843 763 722 703 652 597 556 499 451 
1 2 652 720 
2 6 911 976 1028 1091 1160 1217 
1 3 1028 973 930 
1 5 451 468 461 446 531 
1 5 446 338 380 360 448 
2 8 451 381 315 242 232 210 205 190 
1 4 205 193 177 162 
1 7 162 149 142 134 126 115 107 
4 2 4393 4400 
2 8 1950 1871 1780 1728 1653 1621 1592 1579 
2 9 1950 2007 2128 2221 2326 2406 2413 2388 2516 
1 3 2388 2305 2206 
1 3 1579 1623 1641 
5 2 1825 1833 
3 2 1836 1840 
2 8 1987 1983 1998 2041 2062 2058 2008 2010 
1 4 2062 1995 1957 1913 
1 3 2010 2085 2137 
1 4 1490 1507 1530 1546 
3 3 1530 1584 1616 
1 5 1546 1575 1638 1694 1712 
2 7 1712 1808 1829 1857 1854 1839 1840 
2 6 1840 1814 1771 1695 1625 1616 
3 5 1616 1606 1561 1558 1559 
3 3 1616 1624 1681 
2 4 1681 1682 1691 1671 
3 4 1671 1700 1729 1691 
4 4 1729 1760 1788 1825 
4 3 1833 1837 1836 
3 6 1837 1878 1905 1946 1975 1987 
2 8 1490 1459 1409 1386 1343 1353 1338 1318 
2 4 1318 1351 1403 1417 
3 7 1417 1440 1475 1495 1508 1532 1559 
3 3 1264 1303 1318 
3 4 1264 1223 1228 1226 
2 4 1226 1259 1298 1308 
2 3 1318 1305 1259 
2 3 1226 1181 1144 
3 3 1264 1271 1205 
2 3 1271 1256 1282 
2 7 1205 1202 1211 1248 1268 1300 1291 
1 2 1950 1899 
2 4 1671 1665 1617 1585 
3 4 1665 1677 1674 1642 
1 4 1642 1661 1628 1614 
2 11 1642 1618 1578 1571 1565 1524 1529 1521 1497 1485 1501 
3 4 1485 1464 1453 1418 
1 3 1418 1395 1401 
3 11 1418 1373 1340 1337 1309 1295 1284 1252 1220 1187 1176 
2 8 1340 1311 1288 1272 1241 1197 1193 1199 
3 9 1373 1372 1400 1411 1423 1449 1430 1448 1417 
1 2 1448 1492 
2 6 1308 1319 1314 1306 1320 1372 
1 3 1199 1219 1249 
1 4 1418 1451 1470 1467 
1 7 1249 1232 1189 1162 1151 1150 1144 
3 11 1199 1147 1120 1105 1079 1066 1048 1042 1014 989 952 
2 3 1014 1052 1071 
1 4 1147 1154 1173 1162 
2 6 952 964 958 936 935 972 
2 6 952 922 943 894 905 864 
2 9 952 900 838 783 796 747 727 665 642 
1 3 972 955 887 
1 4 955 957 995 1023 
2 6 1023 1011 992 975 934 898 
2 6 1023 1058 1081 1116 1127 1144 
2 4 1144 1118 1083 1111 
3 11 1083 1067 1080 1065 1034 1013 979 941 961 942 898 
2 11 898 867 813 785 751 723 679 635 608 584 594 
1 9 785 767 740 689 676 627 601 577 517 
1 4 627 638 621 563 
2 5 898 848 794 724 723 
1 5 724 743 698 686 662 
2 4 662 639 613 594 
3 6 594 566 543 514 500 496 
3 3 500 484 477 
2 4 496 481 467 417 
1 5 417 463 472 483 489 
1 3 417 396 383 
2 3 388 391 407 
2 5 388 393 387 386 362 
1 2 386 417 
2 4 642 626 636 613 
1 8 383 369 374 353 332 306 286 288 
1 3 374 392 376 
1 4 286 280 262 287 
2 8 287 279 267 283 298 331 339 364 
2 3 339 310 273 
1 3 273 282 264 
1 2 251 264 
1 6 517 476 464 433 403 364 
1 4 243 238 260 273 
2 4 3941 3932 3912 3883 
2 2 895 924 
3 4 1166 1188 1245 1270 
2 2 1245 1239 
2 6 1239 1273 1296 1310 1325 1349 
1 9 1349 1330 1326 1346 1364 1384 1414 1445 1457 
2 3 1166 1156 1132 
3 3 1834 1827 1801 
2 11 1834 1845 1855 1907 1915 1943 1992 2043 2060 2052 2099 
1 6 1943 1922 1887 1891 1897 1890 
3 5 1834 1796 1790 1745 1747 
2 11 1801 1765 1725 1697 1668 1635 1678 1630 1608 1609 1636 
1 6 1678 1733 1791 1850 1902 1993 
2 15 1834 1781 1756 1708 1707 1696 1675 1687 1684 1649 1620 1590 1569 1544 1535 
1 9 1992 2066 2126 2179 2190 2238 2288 2351 2411 
2 4 2411 2418 2441 2425 
2 5 2425 2382 2337 2295 2271 
3 6 2099 2151 2202 2236 2249 2271 
3 2 2236 2196 
3 11 1658 1640 1632 1611 1594 1587 1564 1536 1560 1591 1599 
3 5 1658 1719 1758 1718 1750 
1 4 1750 1777 1823 1842 
2 4 1720 1752 1795 1824 
4 4 1720 1740 1742 1767 
3 10 1767 1813 1852 1929 1961 1985 2056 2140 2157 2223 
2 7 2140 2172 2186 2231 2264 2315 2320 
2 5 2157 2173 2191 2141 2095 
2 4 2191 2243 2289 2293 
1 3 2289 2313 2334 
2 8 2315 2398 2402 2447 2478 2533 2564 2605 
1 3 1961 2014 2045 
2 5 1767 1806 1835 1895 1948 
2 4 2264 2316 2251 2223 
4 5 1720 1704 1679 1663 1658 
2 3 6728 6785 6856 
2 6 6856 6713 6615 6519 6437 6361 
1 3 6519 6538 6592 
2 4 2965 2940 2948 2938 
3 7 2965 2990 3013 3032 3055 3061 3089 
3 5 2965 2985 3019 3053 3083 
2 5 3083 3113 3152 3181 3204 
2 6 3204 3200 3193 3192 3203 3207 
2 10 3207 3213 3226 3234 3246 3256 3265 3261 3271 3267 
2 7 3261 3249 3241 3220 3210 3202 3191 
2 5 3210 3188 3165 3141 3123 
2 8 3123 3105 3073 3057 3035 2989 2988 2999 
1 4 2989 2936 2894 2876 
1 4 2894 2862 2818 2773 
2 8 3089 3080 3060 3063 3040 3030 3010 2989 
2 5 3207 3189 3169 3129 3089 
3 5 3204 3201 3198 3175 3176 
3 4 3176 3157 3126 3095 
3 5 3176 3167 3149 3137 3122 
2 2 3122 3106 
3 5 3122 3096 3069 3052 3033 
4 3 2965 2955 2913 
2 9 2913 2871 2833 2807 2755 2721 2683 2658 2640 
1 2 2658 2631 
3 7 2985 2975 3014 3025 3028 3071 3095 
1 10 2631 2603 2606 2546 2445 2464 2434 2360 2408 2462 
1 11 2360 2312 2258 2253 2257 2235 2323 2373 2407 2459 2508 
2 2 3256 3264 
3 3 3007 3029 3049 
4 4 3029 3022 3020 3033 
3 6 3007 2973 2949 2915 2908 2935 
3 5 2935 2942 2918 2901 2885 
2 3 2885 2855 2824 
1 4 2885 2872 2841 2803 
2 5 2908 2883 2837 2820 2778 
2 3 2837 2864 2860 
1 5 3033 3038 3051 3058 3028 
2 9 2026 2047 2027 2005 1994 1969 1986 1981 1982 
2 13 2026 2017 2030 2016 2015 2025 2039 2054 2069 2072 2081 2080 2076 
2 5 2660 2692 2691 2665 2707 
2 5 2660 2687 2654 2696 2739 
1 3 2696 2703 2678 
3 9 7542 7537 7460 7426 7344 7278 7244 7176 7128 
2 4 7278 7177 7141 7051 
2 5 7051 7023 7003 7012 6962 
1 5 7012 7094 7155 7246 7294 
1 3 6962 6841 6789 
1 3 7294 7331 7279 
1 3 7294 7236 7095 
1 3 7331 7418 7437 
2 5 7418 7476 7601 7654 7695 
2 5 7542 7521 7522 7543 7476 
2 3 7537 7606 7641 
2 12 7542 7616 7676 7735 7788 7850 7909 7961 8020 8083 8134 8205 
2 5 7616 7694 7750 7805 7858 
1 4 7695 7751 7817 7853 
1 4 7858 7888 7838 7853 
2 5 7888 7936 7984 8027 8028 
1 7 7984 8012 8050 8131 8195 8242 8276 
2 2 4912 4814 
3 3 4912 4990 4980 
1 8 4912 4892 4776 4718 4668 4619 4549 4429 
1 8 4912 4966 5012 5050 5011 4997 4957 4921 
2 5 5347 5280 5214 5215 5233 
2 3 5347 5264 5179 
2 8 5347 5426 5447 5549 5611 5662 5719 5807 
2 6 5447 5407 5406 5425 5498 5524 
1 7 5524 5512 5486 5523 5453 5423 5417 
2 2 6500 6529 
2 4 6529 6712 6831 6933 
1 6 6500 6584 6686 6773 6992 7152 
1 7 6500 6463 6566 6591 6662 6565 6458 
1 2 7563 7583 
1 12 7563 7309 7242 7310 7428 7499 7548 7488 7472 7412 7489 7584 
4 3 8003 7960 7857 
1 2 7857 7976 
2 6 7857 7796 7797 7842 7745 7685 
2 5 8003 7906 7886 7773 7712 
1 7 7773 7663 7536 7435 7323 7251 7063 
3 5 8003 8063 8013 8105 8002 
1 4 8105 8214 8296 8332 
2 9 8332 8453 8577 8633 8751 8828 8903 8953 8990 
1 3 8828 8856 8864 
1 6 8864 8868 8786 8675 8518 8429 
1 5 8868 8882 8902 8842 8732 
1 8 8902 8968 8974 9016 9089 9196 9289 9321 
1 9 7663 7664 7647 7490 7480 7414 7335 7209 7105 
3 6 7105 7048 6968 6899 6816 6714 
1 4 6968 6995 6999 7033 
2 9 6899 6872 6786 6730 6617 6581 6509 6530 6438 
1 3 7033 7000 7028 
3 9 7188 7284 7293 7329 7317 7302 7210 7084 7033 
1 5 7302 7415 7518 7580 7685 
1 3 7148 7121 7105 
2 6 7842 7757 7786 7762 7863 7813 
1 4 7702 7787 7774 7813 
1 5 7643 7613 7716 7778 7813 
1 7 7787 7832 7953 8036 8107 8141 8106 
1 5 7842 7887 8065 8158 8206 
2 8 8206 8173 8267 8339 8340 8430 8450 8532 
1 9 8107 8193 8256 8323 8365 8421 8445 8468 8554 
2 4 8532 8553 8578 8554 
1 4 8532 8573 8609 8617 
2 12 8206 8261 8353 8440 8531 8608 8678 8733 8784 8834 8878 8889 
1 4 8531 8552 8546 8495 
3 8 8495 8396 8351 8293 8196 8139 8087 8003 
1 9 8554 8525 8497 8434 8341 8310 8272 8273 8209 
2 8 8209 8160 8075 8019 7849 7739 7687 7615 
2 18 8273 8274 8317 8334 8371 8417 8465 8526 8568 8610 8651 8705 8744 8777 8806 8820 8843 8858 
2 5 8465 8492 8558 8574 8569 
1 6 8558 8645 8658 8712 8750 8726 
2 6 8878 8933 8983 9000 9042 9068 
1 3 9068 9086 9126 
2 7 8834 8886 8932 8962 8990 9047 9097 
1 3 8495 8602 8703 
2 3 8105 8170 8223 
1 4 8417 8431 8441 8480 
1 3 7953 7952 7983 
