1 7 753 770 771 761 719 725 708 
1 2 761 766 
1 9 771 798 837 856 880 889 919 939 965 
1 15 965 1027 966 985 1009 1021 1038 1049 1063 1064 1075 1103 1107 1125 1117 
1 10 1103 1122 1152 1155 1158 1170 1178 1200 1177 1194 
1 4 1117 1132 1156 1166 
1 5 1166 1190 1215 1206 1238 
1 3 889 901 908 
1 7 965 982 980 968 962 938 908 
1 4 889 893 842 835 
1 5 770 811 830 850 895 
1 5 850 822 861 810 797 
1 14 753 729 697 658 648 669 647 631 634 630 587 550 525 526 
1 4 525 512 492 453 
1 3 630 659 655 
1 5 697 685 717 748 797 
1 2 685 648 
1 3 811 826 837 
1 2 798 826 
1 3 908 886 856 
1 2 893 919 
1 3 1027 993 1021 
1 2 1063 1075 
1 2 492 489 
3 8 4251 4288 4323 4339 4378 4393 4430 4465 
3 6 4251 4244 4278 4294 4247 4220 
3 6 4251 4203 4186 4153 4120 4068 
3 8 4251 4230 4205 4168 4127 4139 4130 4122 
2 4 4127 4108 4069 4046 
3 10 4127 4108 4075 4028 4003 3957 3924 3885 3855 3815 
3 10 4251 4271 4311 4347 4352 4408 4474 4482 4536 4576 
3 11 4408 4466 4526 4567 4625 4631 4583 4525 4481 4447 4407 
3 11 4251 4271 4254 4231 4255 4241 4221 4227 4215 4163 4132 
3 6 4215 4248 4279 4318 4330 4366 
2 6 4366 4419 4438 4475 4520 4585 
3 7 4366 4365 4369 4386 4374 4425 4462 
3 8 4366 4324 4281 4263 4264 4275 4265 4216 
2 5 4216 4219 4222 4213 4198 
2 4 4216 4149 4117 4116 
3 9 4216 4187 4141 4071 4007 3963 3908 3928 3872 
3 11 4216 4187 4141 4096 4059 4060 4061 4080 4053 4054 4005 
2 4 4005 4009 4004 3951 
3 12 4005 3958 3895 3862 3816 3761 3725 3722 3742 3688 3650 3594 
4 16 4005 3968 3906 3858 3801 3850 3866 3857 3794 3773 3716 3684 3646 3613 3575 3554 
3 16 3857 3824 3818 3778 3786 3739 3715 3680 3648 3634 3611 3599 3570 3572 3581 3582 
1 12 5034 4968 4960 4959 4914 4882 4816 4787 4753 4721 4650 4620 
1 8 5034 5097 5154 5224 5293 5392 5504 5570 
1 4 5034 5043 4984 5006 
1 3 5558 5605 5570 
1 8 5034 4972 4906 4852 4777 4738 4716 4656 
1 8 4620 4611 4601 4566 4582 4551 4562 4614 
1 3 4614 4673 4722 
1 4 4614 4674 4711 4788 
1 3 4716 4701 4661 
1 13 5034 5033 5083 5071 5054 5085 5070 5067 5061 5042 5041 5053 5040 
1 6 5034 5033 5083 5071 5054 5009 
1 5 5034 5033 5083 5071 5120 
1 5 5042 5108 5147 5207 5298 
1 2 5147 5234 
1 6 5147 5107 5041 4991 4942 4870 
1 7 4620 4671 4670 4724 4792 4758 4870 
1 6 4722 4787 4851 4948 4992 5009 
1 3 4788 4898 4968 
1 10 5298 5360 5366 5348 5292 5273 5206 5162 5091 5090 
2 4 4407 4396 4413 4408 
3 5 4525 4503 4460 4473 4465 
2 5 4374 4424 4461 4488 4536 
2 4 4462 4513 4530 4585 
2 4 4122 4115 4137 4132 
2 5 4068 4034 4042 4028 4003 
2 4 4068 4094 4136 4127 
2 5 3801 3799 3802 3812 3816 
2 6 3613 3629 3630 3620 3600 3594 
1 5 3857 3881 3935 3994 4007 
1 6 4080 4036 3977 3925 3866 3857 
2 5 3648 3644 3652 3684 3716 
1 4 3778 3793 3811 3872 
2 5 3688 3687 3702 3774 3801 
1 10 3949 3967 3972 3995 4023 4051 4083 4100 4126 4119 
1 10 3949 3967 3972 3946 3923 3896 3897 3898 3834 3810 
1 7 3949 3967 3972 3973 3961 3985 4002 
1 5 3949 3918 3863 3871 3837 
1 8 3949 3938 3914 3945 3933 3917 3922 3941 
1 2 3914 3956 
1 4 3764 3808 3846 3883 
1 4 3764 3808 3798 3848 
1 4 3764 3784 3836 3868 
1 3 3764 3745 3756 
1 4 3632 3639 3610 3617 
1 4 3617 3638 3663 3679 
1 6 3632 3664 3633 3590 3579 3553 
1 10 4632 4686 4739 4764 4857 4933 4994 5036 5086 5142 
1 4 4632 4676 4729 4746 
1 4 4764 4857 4933 4950 
1 8 5209 5208 5240 5173 5137 5109 5056 4995 
1 9 5209 5208 5240 5173 5137 5109 5044 5015 5045 
1 9 5209 5301 5361 5428 5507 5595 5674 5726 5774 
1 5 5595 5596 5608 5632 5617 
1 4 5473 5411 5325 5241 
1 3 5473 5411 5433 
1 3 5473 5609 5617 
1 2 5349 5235 
1 7 5349 5448 5460 5582 5665 5767 5817 
1 6 6104 6011 5972 5923 5823 5822 
1 6 6104 6037 6012 5964 5889 5878 
1 6 6104 6144 6211 6275 6325 6419 
1 3 6104 6158 6236 
1 5 5889 5824 5766 5730 5695 
1 3 5822 5725 5664 
1 4 5889 5910 5924 5972 
1 4 4714 4740 4771 4803 
1 3 4730 4771 4803 
1 14 6047 5983 5966 5911 5858 5768 5745 5668 5607 5534 5462 5409 5332 5283 
1 4 5409 5533 5606 5667 
1 4 6047 6014 5965 5969 
1 11 5911 5880 5825 5851 5836 5893 5958 6015 6006 6022 6051 
1 9 6047 6114 6115 6152 6153 6188 6140 6160 6165 
1 3 6160 6092 6069 
1 3 6160 6092 6006 
1 6 6160 6252 6303 6364 6432 6512 
1 4 6364 6398 6442 6502 
1 8 6502 6608 6700 6788 6840 6891 6973 7002 
1 7 5732 5793 5890 5925 5997 6099 6172 
1 3 5938 5857 5809 
1 4 5938 5879 5850 5865 
1 4 5938 5987 6045 6058 
1 4 5938 6013 6038 6163 
1 9 6669 6567 6544 6431 6373 6342 6315 6203 6139 
1 5 6669 6633 6698 6796 6857 
1 3 6857 6916 7020 
1 4 6857 6916 6839 6875 
1 3 7020 7029 6902 
1 3 6315 6264 6314 
1 8 7188 7140 7091 7028 6926 6874 6805 6679 
1 9 7188 7065 7018 6934 6825 6774 6593 6540 6460 
1 4 6460 6470 6397 6302 
1 5 6460 6470 6511 6606 6697 
1 9 7188 7212 7318 7304 7404 7475 7568 7643 7702 
1 6 7475 7441 7367 7277 7257 7174 
1 5 6453 6376 6288 6224 6183 
1 3 6183 6243 6305 
1 6 6453 6413 6345 6318 6266 6241 
1 3 6241 6174 6084 
1 8 6084 6116 6173 6280 6344 6343 6433 6503 
